jump	jumping
read	reading
run	running
move	moving
generate	generating
sing	singing
predict	predicting
discover	discovering
walk	walking
dance	dancing
play	playing
write	writing
swim	swimming
say	saying
fly	flying
describe	describing
see	seeing
scream	screaming
invent	inventing
listen	listening
think	thinking
