springen	springend
lesen	lesend
ausführen	ausführend
laufen	laufend
bewegen	bewegend
erzeugen	erzeugend
singen	singend
vorhersagen	vorhersagend
entdecken	entdeckend
gehen	gehend
tanzen	tanzend
spielen	spielend
schreiben	schreibend
schwimmen	schwimmend
sagen	sagend
fliegen	fliegend
beschreiben	beschreibend
sehen	sehend
schreien	schreiend
erfinden	erfindend
hören	hörend
denken	denkend
