sauter	sautant
lire	lisant
courir	courant
déplacer	déplaçant
générer	générant
chanter	chantant
prédire	prédisant
découvrir	découvrant
marcher	marchant
danser	dansant
jouer	jouant
écrire	écrivant
nager	nageant
dire	disant
voler	volant
décrire	décrivant
voir	voyant
crier	criant
inventer	inventant
écouter	écoutant
penser	pensant
