saltar	saltando
leer	leyendo
correr	corriendo
mover	moviendo
generar	generando
cantar	cantando
predecir	prediciendo
descubrir	descubriendo
caminar	caminando
baile	bailando
jugar	jugando
escribir	escribiendo
nadar	nadando
decir	diciendo
volar	volando
describir	describiendo
ver	viendo
gritar	gritando
inventar	inventando
escucha	escuchando
pensar	pensando
